########################
#    #                 #
#    #                 #
#    #                 #
#    #                 #
#    #                 #
#    #                 #
#     #                #
#      #               #
#       ################
#                      #
#                      #
#                      #
#                      #
#       ################
#      #               #
#     #                #
#    #                 #
#    #                 #
#    #                 #
#    #                 #
#    #                 #
#    #                 #
########################